        # 0 #      #
 ######### ###### ##
 #                  
 ###-############ ##
 #    #            *
 #-#####-###########
   #                
#######-#######-####
 #         #        
 ##-########-#######
        #         ? 
 ########### #######
          #*       *
########-#######-###
       # #         <
##-###-#-#=#########
                   #
#############=###   
#       #       ####
    #              1